1P0000000000C0000000000001
101111111111X1111111111101
1C1000000000C0000000000101
10101111111111111111110101
1C1C1000000000000000010101
1010100111111111111101C101
1C101C011111E1111111000101
10101000CCCC1CCCCC00010101
10101111111111111111110101
10100000000000000000000101
10111111111111111111111101
1CCCCCCCCCCCCCCCCCCCCCCCC1
11111111111111111111111111