1111111111111111111111
1P00000000001111111111
1011111111000G00000111
1010000001111111111011
1010111001000000001011
1000001001000111111011
1111011001000100000011
1000011001111100111011
101111100000000C0000E1
1111111111111111111111
