111111111111
1P0000111111
10111000C101
100000000001
1G01100000E1
100011110001
111111111111