11111111111111111111
1P000000000000000001
10111000000100E00001
10000000000C10000001
1000000C0001C0000001
10000000000000000001
11111111111111111111
