111111111111
1P0000111111
10111000C101
100000000001
1101100000E1
1G0011110001
111111111111