11111111111111111111
1P000011111100000001
10111000110CC0E00001
10000000000C10000001
1001100C0001C0000001
1000111100000CC00001
11111111111111111111
