111111111111111111111
1P0000000000000000001
101111111111111111101
1C000C000000000000001
101111101111111111101
100000000000C00000001
111111111101111111101
10000C000C000000C0001
101111111111011111111
1G00000000000000E0111
111111111111111111111