1111111111111111111111111111111111111
1P00000000000000000011111111111111111
1011111111111111111011111111111111111
1C000C0000000000000011111111111111111
1011111011111111111011111111111111111
100000000000C000000000000000000CCCCC1
1111111111011111111011111111111111111
1C000C000C000000C00011000000000000001
101111111101111111100000000000000CCC1
10000000000000000E0011111111111111111
1111111111111111111111111111111111111