11111111111111111111111111111111111111
1P000000000000000000111111111111111111
10111111111111111110111111111111111111
1C000C00000000000000111111111111111111
10111110111111111110111111111111111111
100000000000C000000000000000000CCCCC11
11111111110111111110111111111111111111
1C000C000C000000C000110000000000000011
101111111101111111100000000000000CCC11
10000G00000000000E00111111111111111111
11111111111111111111111111111111111111