111111111111111111111111
1P0000000000000000000011
101111101111111111101101
100C000100000000001C0001
101111101111111111101101
100000000000000000001001
1111111111G1111111111101
100000000100000000000101
101111101101111111111101
1000001001000000000000E1
111111111111111111111111
