111111111111111111111111
1G0000000000P00000000001
101111111111111111111101
100000000000000000001C01
101111111111111111101101
100000000000000000100001
101111111111111111101111
1000000000000000001000E1
111111111111111111111111
