1111111111111111111111
1P000000000G1111111111
1011111111000000000011
1010000001111111111011
1010111001000000001011
1000001001000111111011
11110110010001C0000011
10000110011111C0111111
101111100000000C0000E1
1111111111111111111111
